# # # # # # # # # # # # # # #
# # X # C C C # # C C C # @ #
# # & # C # C # # C # C # C #
# # C # C # C # # C # C # C #
# # C # C # C # # C # C # C #
# # C # C # C # C C # C # C #
# # C # C # C # C # C C # C #
# # C # C # C # C # C # # C #
# # C C C # C C C # % # % C #
# # # # # # # # # # # # # # #